################################################
#                                              #
#                                              #
#                                              #
#  ######                              ######  #
#  #                                        #  #
#  #                                        #  #
#  #                                        #  #
#  #                                        #  #
#  #                    #                   #  #
#                       #                      #
#                       #                      #
#                  ###########                 #
#                       #                      #
#                       #                      #
#  #                    #                   #  #
#  #                                        #  #
#  #                                        #  #
#  #                    C                   #  #
#  #                                        #  #
#  ######                              ######  #
#                                              #
#                                              #
#                                              #
#                                              #
################################################
