#######################
#                     #
# ### #### # #### ### #
#          #          #
# ### #### # #### ### #
#          #          #
#       #######       #
#                     #
#  #################  #
#          C          #
# #######     ####### #
#                     #
# ##### ####### ##### #
#       #     #       #
# ##### #  #  # ##### #
# ##### #  #  # ##### #
#          #          #
#     # #  #  # #     #
#     # #  #  # #     #
#     # #     # #     #
# ##### ### ### ##### #
#                     #
#######################
